0030000000
0010000000
0010000000
0010022200
0010020100
0010020100
0010020100
0010020100
0010010100
0010010100
0010010100
0011110100
0000000100
5555555555